"filename", "language", "JavaScript", "Pug", "JSON", "comment", "blank", "total"
"/Users/egormaksimov/Documents/PROGRAMMING/instagram/server/app.js", "JavaScript", 22, 0, 0, 0, 12, 34
"/Users/egormaksimov/Documents/PROGRAMMING/instagram/server/controllers/authController.js", "JavaScript", 132, 0, 0, 6, 22, 160
"/Users/egormaksimov/Documents/PROGRAMMING/instagram/server/controllers/errorController.js", "JavaScript", 48, 0, 0, 0, 6, 54
"/Users/egormaksimov/Documents/PROGRAMMING/instagram/server/controllers/friendsController.js", "JavaScript", 29, 0, 0, 0, 6, 35
"/Users/egormaksimov/Documents/PROGRAMMING/instagram/server/controllers/handlerFactory.js", "JavaScript", 14, 0, 0, 0, 2, 16
"/Users/egormaksimov/Documents/PROGRAMMING/instagram/server/controllers/messangerController.js", "JavaScript", 38, 0, 0, 0, 10, 48
"/Users/egormaksimov/Documents/PROGRAMMING/instagram/server/controllers/postsController.js", "JavaScript", 94, 0, 0, 5, 22, 121
"/Users/egormaksimov/Documents/PROGRAMMING/instagram/server/controllers/socketController.js", "JavaScript", 20, 0, 0, 1, 6, 27
"/Users/egormaksimov/Documents/PROGRAMMING/instagram/server/controllers/userController.js", "JavaScript", 71, 0, 0, 1, 18, 90
"/Users/egormaksimov/Documents/PROGRAMMING/instagram/server/db.js", "JavaScript", 9, 0, 0, 0, 1, 10
"/Users/egormaksimov/Documents/PROGRAMMING/instagram/server/models/messangerModel.js", "JavaScript", 102, 0, 0, 0, 6, 108
"/Users/egormaksimov/Documents/PROGRAMMING/instagram/server/models/passwordResetTokensModel.js", "JavaScript", 71, 0, 0, 0, 16, 87
"/Users/egormaksimov/Documents/PROGRAMMING/instagram/server/models/postsModel.js", "JavaScript", 167, 0, 0, 0, 11, 178
"/Users/egormaksimov/Documents/PROGRAMMING/instagram/server/models/userModel.js", "JavaScript", 134, 0, 0, 0, 23, 157
"/Users/egormaksimov/Documents/PROGRAMMING/instagram/server/package-lock.json", "JSON", 0, 0, 6036, 0, 1, 6037
"/Users/egormaksimov/Documents/PROGRAMMING/instagram/server/package.json", "JSON", 0, 0, 36, 0, 1, 37
"/Users/egormaksimov/Documents/PROGRAMMING/instagram/server/routes/friendsRoutes.js", "JavaScript", 9, 0, 0, 0, 4, 13
"/Users/egormaksimov/Documents/PROGRAMMING/instagram/server/routes/messangerRoutes.js", "JavaScript", 13, 0, 0, 0, 5, 18
"/Users/egormaksimov/Documents/PROGRAMMING/instagram/server/routes/postsRoutes.js", "JavaScript", 20, 0, 0, 0, 13, 33
"/Users/egormaksimov/Documents/PROGRAMMING/instagram/server/routes/userRoutes.js", "JavaScript", 20, 0, 0, 0, 7, 27
"/Users/egormaksimov/Documents/PROGRAMMING/instagram/server/server.js", "JavaScript", 36, 0, 0, 2, 12, 50
"/Users/egormaksimov/Documents/PROGRAMMING/instagram/server/utils/appErrors.js", "JavaScript", 10, 0, 0, 0, 3, 13
"/Users/egormaksimov/Documents/PROGRAMMING/instagram/server/utils/catchAsync.js", "JavaScript", 5, 0, 0, 0, 0, 5
"/Users/egormaksimov/Documents/PROGRAMMING/instagram/server/utils/emailSender.js", "JavaScript", 52, 0, 0, 0, 8, 60
"/Users/egormaksimov/Documents/PROGRAMMING/instagram/server/utils/serverConfig.js", "JavaScript", 4, 0, 0, 0, 1, 5
"/Users/egormaksimov/Documents/PROGRAMMING/instagram/server/views/email/_style.pug", "Pug", 0, 264, 0, 2, 2, 268
"/Users/egormaksimov/Documents/PROGRAMMING/instagram/server/views/email/baseEmail.pug", "Pug", 0, 36, 0, 3, 5, 44
"/Users/egormaksimov/Documents/PROGRAMMING/instagram/server/views/email/passwordReset.pug", "Pug", 0, 16, 0, 0, 2, 18
"/Users/egormaksimov/Documents/PROGRAMMING/instagram/server/views/email/welcome.pug", "Pug", 0, 14, 0, 0, 1, 15
"Total", "-", 1120, 330, 6072, 20, 226, 7768