"filename", "language", "TypeScript JSX", "TypeScript", "XML", "comment", "blank", "total"
"/Users/egormaksimov/Documents/PROGRAMMING/instagram/client/src/App.tsx", "TypeScript JSX", 15, 0, 0, 0, 4, 19
"/Users/egormaksimov/Documents/PROGRAMMING/instagram/client/src/ContextProviders/ClienErrorHandlingProvider.tsx", "TypeScript JSX", 34, 0, 0, 0, 8, 42
"/Users/egormaksimov/Documents/PROGRAMMING/instagram/client/src/ContextProviders/FileLoadProvider.tsx", "TypeScript JSX", 29, 0, 0, 0, 7, 36
"/Users/egormaksimov/Documents/PROGRAMMING/instagram/client/src/ContextProviders/ThemeContextProvider.tsx", "TypeScript JSX", 35, 0, 0, 0, 8, 43
"/Users/egormaksimov/Documents/PROGRAMMING/instagram/client/src/ContextProviders/WidthProivder.tsx", "TypeScript JSX", 42, 0, 0, 0, 9, 51
"/Users/egormaksimov/Documents/PROGRAMMING/instagram/client/src/app/hooks.tsx", "TypeScript JSX", 5, 0, 0, 1, 1, 7
"/Users/egormaksimov/Documents/PROGRAMMING/instagram/client/src/app/store.tsx", "TypeScript JSX", 19, 0, 0, 2, 3, 24
"/Users/egormaksimov/Documents/PROGRAMMING/instagram/client/src/components/AddNewPostComponents/ModalToAddPost.tsx", "TypeScript JSX", 175, 0, 0, 33, 22, 230
"/Users/egormaksimov/Documents/PROGRAMMING/instagram/client/src/components/AddNewPostComponents/NewImagesSwiper.tsx", "TypeScript JSX", 50, 0, 0, 0, 6, 56
"/Users/egormaksimov/Documents/PROGRAMMING/instagram/client/src/components/AuthorizationForm.tsx", "TypeScript JSX", 79, 0, 0, 0, 8, 87
"/Users/egormaksimov/Documents/PROGRAMMING/instagram/client/src/components/Contacts/ContactsContainer.tsx", "TypeScript JSX", 91, 0, 0, 1, 15, 107
"/Users/egormaksimov/Documents/PROGRAMMING/instagram/client/src/components/Contacts/ContactsPresentaional.tsx", "TypeScript JSX", 96, 0, 0, 0, 8, 104
"/Users/egormaksimov/Documents/PROGRAMMING/instagram/client/src/components/Contacts/contactBox.tsx/contactBox.tsx", "TypeScript JSX", 109, 0, 0, 0, 11, 120
"/Users/egormaksimov/Documents/PROGRAMMING/instagram/client/src/components/Conversations/ConversationPresentational.tsx", "TypeScript JSX", 269, 0, 0, 0, 15, 284
"/Users/egormaksimov/Documents/PROGRAMMING/instagram/client/src/components/Conversations/ConversationsContainer.tsx", "TypeScript JSX", 135, 0, 0, 4, 19, 158
"/Users/egormaksimov/Documents/PROGRAMMING/instagram/client/src/components/Conversations/DefaultConversation.tsx", "TypeScript JSX", 50, 0, 0, 0, 7, 57
"/Users/egormaksimov/Documents/PROGRAMMING/instagram/client/src/components/Conversations/FileMessage/File.tsx", "TypeScript JSX", 78, 0, 0, 0, 11, 89
"/Users/egormaksimov/Documents/PROGRAMMING/instagram/client/src/components/Conversations/FileMessage/FileMessage.tsx", "TypeScript JSX", 47, 0, 0, 0, 7, 54
"/Users/egormaksimov/Documents/PROGRAMMING/instagram/client/src/components/Conversations/FileMessage/RecievedFileMessage.tsx", "TypeScript JSX", 77, 0, 0, 0, 9, 86
"/Users/egormaksimov/Documents/PROGRAMMING/instagram/client/src/components/Conversations/FileMessage/SentFileMessages.tsx", "TypeScript JSX", 67, 0, 0, 0, 10, 77
"/Users/egormaksimov/Documents/PROGRAMMING/instagram/client/src/components/Conversations/FilesModal/AttachedFilesModal.tsx", "TypeScript JSX", 214, 0, 0, 0, 21, 235
"/Users/egormaksimov/Documents/PROGRAMMING/instagram/client/src/components/Conversations/FilesModal/FilesBox.tsx", "TypeScript JSX", 37, 0, 0, 0, 5, 42
"/Users/egormaksimov/Documents/PROGRAMMING/instagram/client/src/components/Conversations/Messages/Messages.tsx", "TypeScript JSX", 127, 0, 0, 0, 10, 137
"/Users/egormaksimov/Documents/PROGRAMMING/instagram/client/src/components/Dashboard.tsx", "TypeScript JSX", 69, 0, 0, 42, 7, 118
"/Users/egormaksimov/Documents/PROGRAMMING/instagram/client/src/components/Emoji/EmojiPicker.tsx", "TypeScript JSX", 43, 0, 0, 0, 6, 49
"/Users/egormaksimov/Documents/PROGRAMMING/instagram/client/src/components/ErrorPopUp.tsx", "TypeScript JSX", 45, 0, 0, 0, 8, 53
"/Users/egormaksimov/Documents/PROGRAMMING/instagram/client/src/components/FindFriendsSideBar.tsx", "TypeScript JSX", 256, 0, 0, 0, 28, 284
"/Users/egormaksimov/Documents/PROGRAMMING/instagram/client/src/components/FollowingPostsComponents/Comments.tsx", "TypeScript JSX", 203, 0, 0, 0, 14, 217
"/Users/egormaksimov/Documents/PROGRAMMING/instagram/client/src/components/FollowingPostsComponents/FollowingPostsSwiper.tsx", "TypeScript JSX", 117, 0, 0, 0, 9, 126
"/Users/egormaksimov/Documents/PROGRAMMING/instagram/client/src/components/FollowingPostsComponents/ModalWindowForPosts.tsx", "TypeScript JSX", 119, 0, 0, 0, 17, 136
"/Users/egormaksimov/Documents/PROGRAMMING/instagram/client/src/components/FollowingPostsComponents/PostInfoComponent.tsx", "TypeScript JSX", 123, 0, 0, 0, 16, 139
"/Users/egormaksimov/Documents/PROGRAMMING/instagram/client/src/components/GridColumn.tsx", "TypeScript JSX", 53, 0, 0, 0, 7, 60
"/Users/egormaksimov/Documents/PROGRAMMING/instagram/client/src/components/Header.tsx", "TypeScript JSX", 76, 0, 0, 0, 10, 86
"/Users/egormaksimov/Documents/PROGRAMMING/instagram/client/src/components/ModalWindow/ModalWindow.tsx", "TypeScript JSX", 69, 0, 0, 0, 9, 78
"/Users/egormaksimov/Documents/PROGRAMMING/instagram/client/src/components/Post.tsx", "TypeScript JSX", 139, 0, 0, 0, 15, 154
"/Users/egormaksimov/Documents/PROGRAMMING/instagram/client/src/components/ProfilePosts/ProfilePostsContainer.tsx", "TypeScript JSX", 48, 0, 0, 0, 9, 57
"/Users/egormaksimov/Documents/PROGRAMMING/instagram/client/src/components/ProfilePosts/ProfilePostsPresentational.tsx", "TypeScript JSX", 68, 0, 0, 0, 7, 75
"/Users/egormaksimov/Documents/PROGRAMMING/instagram/client/src/components/ProfilePosts/ProfilePostsSwiper.tsx", "TypeScript JSX", 47, 0, 0, 0, 7, 54
"/Users/egormaksimov/Documents/PROGRAMMING/instagram/client/src/components/ProgressCircle.tsx", "TypeScript JSX", 53, 0, 0, 0, 9, 62
"/Users/egormaksimov/Documents/PROGRAMMING/instagram/client/src/components/StyledIcons.tsx", "TypeScript JSX", 77, 0, 0, 0, 14, 91
"/Users/egormaksimov/Documents/PROGRAMMING/instagram/client/src/components/Theme/Themes.tsx", "TypeScript JSX", 99, 0, 0, 1, 1, 101
"/Users/egormaksimov/Documents/PROGRAMMING/instagram/client/src/components/Theme/globalStyles.tsx", "TypeScript JSX", 29, 0, 0, 0, 2, 31
"/Users/egormaksimov/Documents/PROGRAMMING/instagram/client/src/components/ThreeDotsMenu.tsx", "TypeScript JSX", 104, 0, 0, 0, 7, 111
"/Users/egormaksimov/Documents/PROGRAMMING/instagram/client/src/components/Toggler.tsx", "TypeScript JSX", 35, 0, 0, 0, 5, 40
"/Users/egormaksimov/Documents/PROGRAMMING/instagram/client/src/components/custom.d.ts", "TypeScript", 0, 4, 0, 0, 0, 4
"/Users/egormaksimov/Documents/PROGRAMMING/instagram/client/src/features/friends/conversationsSlice.tsx", "TypeScript JSX", 32, 0, 0, 1, 7, 40
"/Users/egormaksimov/Documents/PROGRAMMING/instagram/client/src/features/messages/messagesSlice.tsx", "TypeScript JSX", 45, 0, 0, 0, 5, 50
"/Users/egormaksimov/Documents/PROGRAMMING/instagram/client/src/features/posts/accountPostsSlice.tsx", "TypeScript JSX", 62, 0, 0, 1, 7, 70
"/Users/egormaksimov/Documents/PROGRAMMING/instagram/client/src/features/posts/followingsPostsSlice.tsx", "TypeScript JSX", 76, 0, 0, 1, 8, 85
"/Users/egormaksimov/Documents/PROGRAMMING/instagram/client/src/features/posts/userPostsSlice.tsx", "TypeScript JSX", 72, 0, 0, 1, 7, 80
"/Users/egormaksimov/Documents/PROGRAMMING/instagram/client/src/features/user/userSlice.tsx", "TypeScript JSX", 36, 0, 0, 1, 7, 44
"/Users/egormaksimov/Documents/PROGRAMMING/instagram/client/src/hocs/PrivateMessageRoute.tsx", "TypeScript JSX", 34, 0, 0, 0, 8, 42
"/Users/egormaksimov/Documents/PROGRAMMING/instagram/client/src/hocs/PrivateRoute.tsx", "TypeScript JSX", 31, 0, 0, 1, 9, 41
"/Users/egormaksimov/Documents/PROGRAMMING/instagram/client/src/hooks/fetchHooks/authorization/useIsLogedIn.tsx", "TypeScript JSX", 49, 0, 0, 0, 6, 55
"/Users/egormaksimov/Documents/PROGRAMMING/instagram/client/src/hooks/fetchHooks/authorization/useResendEmialConfirmation.tsx", "TypeScript JSX", 37, 0, 0, 0, 3, 40
"/Users/egormaksimov/Documents/PROGRAMMING/instagram/client/src/hooks/fetchHooks/authorization/useSignIn.tsx", "TypeScript JSX", 59, 0, 0, 0, 8, 67
"/Users/egormaksimov/Documents/PROGRAMMING/instagram/client/src/hooks/fetchHooks/authorization/useSignUp.tsx", "TypeScript JSX", 71, 0, 0, 0, 10, 81
"/Users/egormaksimov/Documents/PROGRAMMING/instagram/client/src/hooks/fetchHooks/main/useGetSubscribersPosts.tsx", "TypeScript JSX", 49, 0, 0, 2, 7, 58
"/Users/egormaksimov/Documents/PROGRAMMING/instagram/client/src/hooks/fetchHooks/messanger/useCreateConversation.tsx", "TypeScript JSX", 32, 0, 0, 0, 6, 38
"/Users/egormaksimov/Documents/PROGRAMMING/instagram/client/src/hooks/fetchHooks/messanger/useGetConversationsAndMessages.tsx", "TypeScript JSX", 61, 0, 0, 2, 6, 69
"/Users/egormaksimov/Documents/PROGRAMMING/instagram/client/src/hooks/fetchHooks/messanger/useMessageLoad.tsx", "TypeScript JSX", 38, 0, 0, 0, 3, 41
"/Users/egormaksimov/Documents/PROGRAMMING/instagram/client/src/hooks/fetchHooks/messanger/useSendFile.tsx", "TypeScript JSX", 48, 0, 0, 0, 5, 53
"/Users/egormaksimov/Documents/PROGRAMMING/instagram/client/src/hooks/fetchHooks/profile/useGetPosts.tsx", "TypeScript JSX", 31, 0, 0, 0, 3, 34
"/Users/egormaksimov/Documents/PROGRAMMING/instagram/client/src/hooks/fetchHooks/profile/useGetProfileInfo.tsx", "TypeScript JSX", 24, 0, 0, 0, 4, 28
"/Users/egormaksimov/Documents/PROGRAMMING/instagram/client/src/hooks/fetchHooks/useFetch.tsx", "TypeScript JSX", 36, 0, 0, 0, 11, 47
"/Users/egormaksimov/Documents/PROGRAMMING/instagram/client/src/hooks/fetchHooks/users/useGetUsers.tsx", "TypeScript JSX", 64, 0, 0, 0, 8, 72
"/Users/egormaksimov/Documents/PROGRAMMING/instagram/client/src/hooks/useDarkMode.tsx", "TypeScript JSX", 21, 0, 0, 0, 6, 27
"/Users/egormaksimov/Documents/PROGRAMMING/instagram/client/src/hooks/useOutsideAlerter.tsx", "TypeScript JSX", 14, 0, 0, 0, 2, 16
"/Users/egormaksimov/Documents/PROGRAMMING/instagram/client/src/hooks/useResize.tsx", "TypeScript JSX", 12, 0, 0, 0, 2, 14
"/Users/egormaksimov/Documents/PROGRAMMING/instagram/client/src/hooks/useSocketSetup.tsx", "TypeScript JSX", 73, 0, 0, 1, 10, 84
"/Users/egormaksimov/Documents/PROGRAMMING/instagram/client/src/index.tsx", "TypeScript JSX", 25, 0, 0, 2, 3, 30
"/Users/egormaksimov/Documents/PROGRAMMING/instagram/client/src/lib/errors/Errors.tsx", "TypeScript JSX", 3, 0, 0, 0, 0, 3
"/Users/egormaksimov/Documents/PROGRAMMING/instagram/client/src/lib/likes/like.tsx", "TypeScript JSX", 25, 0, 0, 3, 4, 32
"/Users/egormaksimov/Documents/PROGRAMMING/instagram/client/src/lib/main/generateMasonryGrid.tsx", "TypeScript JSX", 52, 0, 0, 0, 4, 56
"/Users/egormaksimov/Documents/PROGRAMMING/instagram/client/src/lib/messanger/installFile.tsx", "TypeScript JSX", 36, 0, 0, 0, 1, 37
"/Users/egormaksimov/Documents/PROGRAMMING/instagram/client/src/lib/messanger/sendMessage.tsx", "TypeScript JSX", 31, 0, 0, 0, 8, 39
"/Users/egormaksimov/Documents/PROGRAMMING/instagram/client/src/lib/messanger/useCreateOrGetConversation.tsx", "TypeScript JSX", 29, 0, 0, 3, 1, 33
"/Users/egormaksimov/Documents/PROGRAMMING/instagram/client/src/otherFiles/leftArrow.svg", "XML", 0, 0, 42, 1, 1, 44
"/Users/egormaksimov/Documents/PROGRAMMING/instagram/client/src/otherFiles/messangerIcon.svg", "XML", 0, 0, 49, 1, 1, 51
"/Users/egormaksimov/Documents/PROGRAMMING/instagram/client/src/routes/Account/Account.tsx", "TypeScript JSX", 46, 0, 0, 0, 5, 51
"/Users/egormaksimov/Documents/PROGRAMMING/instagram/client/src/routes/Account/AccountPostsContainer.tsx", "TypeScript JSX", 50, 0, 0, 0, 9, 59
"/Users/egormaksimov/Documents/PROGRAMMING/instagram/client/src/routes/EmailConfirmation.tsx", "TypeScript JSX", 64, 0, 0, 0, 12, 76
"/Users/egormaksimov/Documents/PROGRAMMING/instagram/client/src/routes/Friends/FriendsContainer.tsx", "TypeScript JSX", 55, 0, 0, 0, 5, 60
"/Users/egormaksimov/Documents/PROGRAMMING/instagram/client/src/routes/Friends/FriendsPresentational.tsx", "TypeScript JSX", 57, 0, 0, 0, 7, 64
"/Users/egormaksimov/Documents/PROGRAMMING/instagram/client/src/routes/Login/LoginContainer.tsx", "TypeScript JSX", 60, 0, 0, 0, 5, 65
"/Users/egormaksimov/Documents/PROGRAMMING/instagram/client/src/routes/Login/LoginPresentational.tsx", "TypeScript JSX", 200, 0, 0, 0, 14, 214
"/Users/egormaksimov/Documents/PROGRAMMING/instagram/client/src/routes/Main/MainContainer.tsx", "TypeScript JSX", 63, 0, 0, 1, 9, 73
"/Users/egormaksimov/Documents/PROGRAMMING/instagram/client/src/routes/Main/MainPresentational.tsx", "TypeScript JSX", 64, 0, 0, 0, 10, 74
"/Users/egormaksimov/Documents/PROGRAMMING/instagram/client/src/routes/Messanger.tsx", "TypeScript JSX", 35, 0, 0, 0, 5, 40
"/Users/egormaksimov/Documents/PROGRAMMING/instagram/client/src/routes/NotFound.tsx", "TypeScript JSX", 6, 0, 0, 0, 1, 7
"/Users/egormaksimov/Documents/PROGRAMMING/instagram/client/src/routes/PasswordReset.tsx", "TypeScript JSX", 133, 0, 0, 6, 12, 151
"/Users/egormaksimov/Documents/PROGRAMMING/instagram/client/src/routes/PasswordResetRequest.tsx", "TypeScript JSX", 127, 0, 0, 0, 11, 138
"/Users/egormaksimov/Documents/PROGRAMMING/instagram/client/src/routes/Profile/ProfileContainer.tsx", "TypeScript JSX", 72, 0, 0, 0, 9, 81
"/Users/egormaksimov/Documents/PROGRAMMING/instagram/client/src/routes/Profile/ProfilePresentational.tsx", "TypeScript JSX", 151, 0, 0, 32, 13, 196
"/Users/egormaksimov/Documents/PROGRAMMING/instagram/client/src/routes/Registration/RegistrationContainer.tsx", "TypeScript JSX", 73, 0, 0, 0, 7, 80
"/Users/egormaksimov/Documents/PROGRAMMING/instagram/client/src/routes/Registration/RegistrationPresentational.tsx", "TypeScript JSX", 189, 0, 0, 0, 6, 195
"/Users/egormaksimov/Documents/PROGRAMMING/instagram/client/src/socket.tsx", "TypeScript JSX", 6, 0, 0, 0, 2, 8
"Total", "-", 6511, 4, 91, 144, 754, 7504